#####
#...#
#...#
#..W#
#####
