........
........
...#....
..PW#...
...#....
........
........
