........
........
PPPP.PPP
........
.PPPPPPP
........
..P.....
..W.#...
........
..P.....
