...P......
...P......
...P......
PPPP......
..........
..........
..W.......
