.........
.#..#....
..#P#P#..
#.#.W.#..
..#.P.#..
.###.##.#
......#..
