...................
.#################.
.#...............#.
.#.####.########.#.
.#.#...........#.#.
.#.#.#########.#.#.
.#.#.#W......#.#.#.
.#.#.#####.###.#.#.
.#.#...........#.#.
.#.#############.#.
.#...............#.
.##########.######.
...................
