.........
..#######
..#######
..#######
..PPPW###
..#######
..#######
..#######
.........
