.............
.###.######..
.#...........
.#.#.###.###.
...#...#.#...
.#####.#.#.##
.#PPPP.#.#.#.
.#########.#.
...........#.
#.#.#.######.
..#.#........
.##P#.###.###
..#P#.#......
###P#.#.#####
PPPP#.#..PPPW
